#######################################################################################################################################################################
#                                                                                                                                                                     #
#                                                                                                                                                                     #
#                                                                                                                                                                     #
#                                                                                                                                                                     #
#                                                                                                                                                                     #
#                                                                                                                                                                     #
#                                                                                                                                                                     #
#                                                                                                                                                                     #
#                                                                                                                                                                     #
#                                                                                                                                                                     #
#                                                                                                                                                                     #
#                                                                                                                                                                     #
#                                                                                                                                                                     #
#                           ##################################                                                                                                        #
#                           #                                #                                                                                                        #
#                           #                                #                                                                                                        #
#                           #                                #                                                                                                        #
#                           #                                                                                                                                         #
#                           #                                #                                                                                                        #
#                           #                                #                                                                                                        #
#                           #                                #                                                                                                        #
#                           #                                #                                                                                                        #
#                           #                                #                                                                                                        #
#                           #                                #                                                                                                        #
#                           #                                #                                                                                                        #
#                           #                                #                                                                                                        #
#                           ##################################                                                                                                        #
#                                                                                                                                                                     #
#                                                                                                                                                                     #
#                                                                                                                                                                     #
#                                                                                                                                                                     #
#                                                                                                                                                                     #
#                                                                                                                                                                     #
#                                                                                                                                                                     #
#                                                                                                                                                                     #
# #### ##############################################################################################################                                                 #
# #           #             #                                                                                       #                                                 #
# #          #              # #################################### #                                                #                                                 #
# ###### ########### ###### # #                                  # #                                                #                                                 #
# #                       # # #                                  # #                                                #                                                 #
# #                       # # #                                  # #                                                #                                                 #
# #                       # # #                                  # #                                                #                                                 #
# #                       # # #                                  # #                                                #                                                 #
# #                       # # #                                  # #                                                #                                                 #
# #                       # # #                                  # #                                                                                                  #
# #                       # # #                                    #                                                #                                                 #
# #                       # # #                                  # #                                                #                                                 #
# ########### ############# # #                                  # #                                               ##                                                 #
#             #               #                                  #                                                #                                                   #
#######################################################################################################################################################################